
		From Wikipedia, the free encyclopedia
		
		
		
		
		Jump to navigation
		Jump to search
		British geophysicist and Provost of the Queen's College, Oxford
Claire Harvey Craig CBE is a British geophysicist, civil servant and science communicator. Since 2019, she has been Provost of The Queen's College, Oxford.

Education[edit]
Craig was educated at Newnham College, Cambridge, where she gained a BA in natural science in 1982. In 1986, she was awarded a Doctor of Philosophy, also from the University of Cambridge.[1]

Career[edit]
Craig was the Director of Government Office for Science and later Chief Science Policy Officer at the Royal Society.[2]
Craig was appointed Commander of the Order of the British Empire (CBE) in the 2006 Birthday Honours in recognition of her role in the development of Foresight, the UK government’s scientific-based strategic futures program.[3]
On 10 October 2018 it was announced that she had been pre-elected to serve as the next Provost of The Queen's College, Oxford from 2 August 2019; she is the first woman to hold the post.[4]

References[edit]
.mw-parser-output .reflist{font-size:90%;margin-bottom:0.5em;list-style-type:decimal}.mw-parser-output .reflist .references{font-size:100%;margin-bottom:0;list-style-type:inherit}.mw-parser-output .reflist-columns-2{column-width:30em}.mw-parser-output .reflist-columns-3{column-width:25em}.mw-parser-output .reflist-columns{margin-top:0.3em}.mw-parser-output .reflist-columns ol{margin-top:0}.mw-parser-output .reflist-columns li{page-break-inside:avoid;break-inside:avoid-column}.mw-parser-output .reflist-upper-alpha{list-style-type:upper-alpha}.mw-parser-output .reflist-upper-roman{list-style-type:upper-roman}.mw-parser-output .reflist-lower-alpha{list-style-type:lower-alpha}.mw-parser-output .reflist-lower-greek{list-style-type:lower-greek}.mw-parser-output .reflist-lower-roman{list-style-type:lower-roman}

^ .mw-parser-output cite.citation{font-style:inherit;word-wrap:break-word}.mw-parser-output .citation q{quotes:"\"""\"""'""'"}.mw-parser-output .citation:target{background-color:rgba(0,127,255,0.133)}.mw-parser-output .id-lock-free a,.mw-parser-output .citation .cs1-lock-free a{background:linear-gradient(transparent,transparent),url("//upload.wikimedia.org/wikipedia/commons/6/65/Lock-green.svg")right 0.1em center/9px no-repeat}.mw-parser-output .id-lock-limited a,.mw-parser-output .id-lock-registration a,.mw-parser-output .citation .cs1-lock-limited a,.mw-parser-output .citation .cs1-lock-registration a{background:linear-gradient(transparent,transparent),url("//upload.wikimedia.org/wikipedia/commons/d/d6/Lock-gray-alt-2.svg")right 0.1em center/9px no-repeat}.mw-parser-output .id-lock-subscription a,.mw-parser-output .citation .cs1-lock-subscription a{background:linear-gradient(transparent,transparent),url("//upload.wikimedia.org/wikipedia/commons/a/aa/Lock-red-alt-2.svg")right 0.1em center/9px no-repeat}.mw-parser-output .cs1-ws-icon a{background:linear-gradient(transparent,transparent),url("//upload.wikimedia.org/wikipedia/commons/4/4c/Wikisource-logo.svg")right 0.1em center/12px no-repeat}.mw-parser-output .cs1-code{color:inherit;background:inherit;border:none;padding:inherit}.mw-parser-output .cs1-hidden-error{display:none;color:#d33}.mw-parser-output .cs1-visible-error{color:#d33}.mw-parser-output .cs1-maint{display:none;color:#3a3;margin-left:0.3em}.mw-parser-output .cs1-format{font-size:95%}.mw-parser-output .cs1-kern-left{padding-left:0.2em}.mw-parser-output .cs1-kern-right{padding-right:0.2em}.mw-parser-output .citation .mw-selflink{font-weight:inherit}Yvonne Craig Inskip. "Yvonne Craig Inskip (NC 1955) – A family of women activists" (PDF). Changing Lives. No. Summer 2015. Cambridge: Newnham College, Cambridge. p. 6. Retrieved 2 August 2019.

^ "Claire Craig". The Royal Society. Retrieved 2018-10-19.

^ "No. 58014". The London Gazette (1st supplement). 17 June 2006. pp. 1–28.

^ "The Queen's College announces pre-election of its next Provost". The Queen's College. Retrieved 2018-10-19.





Academic offices


Preceded byPaul Madden

 Provost of The Queen's College, Oxford 2019 -

Succeeded byIncumbent


.mw-parser-output .navbox{box-sizing:border-box;border:1px solid #a2a9b1;width:100%;clear:both;font-size:88%;text-align:center;padding:1px;margin:1em auto 0}.mw-parser-output .navbox .navbox{margin-top:0}.mw-parser-output .navbox+.navbox,.mw-parser-output .navbox+.navbox-styles+.navbox{margin-top:-1px}.mw-parser-output .navbox-inner,.mw-parser-output .navbox-subgroup{width:100%}.mw-parser-output .navbox-group,.mw-parser-output .navbox-title,.mw-parser-output .navbox-abovebelow{padding:0.25em 1em;line-height:1.5em;text-align:center}.mw-parser-output .navbox-group{white-space:nowrap;text-align:right}.mw-parser-output .navbox,.mw-parser-output .navbox-subgroup{background-color:#fdfdfd}.mw-parser-output .navbox-list{line-height:1.5em;border-color:#fdfdfd}.mw-parser-output .navbox-list-with-group{text-align:left;border-left-width:2px;border-left-style:solid}.mw-parser-output tr+tr>.navbox-abovebelow,.mw-parser-output tr+tr>.navbox-group,.mw-parser-output tr+tr>.navbox-image,.mw-parser-output tr+tr>.navbox-list{border-top:2px solid #fdfdfd}.mw-parser-output .navbox-title{background-color:#ccf}.mw-parser-output .navbox-abovebelow,.mw-parser-output .navbox-group,.mw-parser-output .navbox-subgroup .navbox-title{background-color:#ddf}.mw-parser-output .navbox-subgroup .navbox-group,.mw-parser-output .navbox-subgroup .navbox-abovebelow{background-color:#e6e6ff}.mw-parser-output .navbox-even{background-color:#f7f7f7}.mw-parser-output .navbox-odd{background-color:transparent}.mw-parser-output .navbox .hlist td dl,.mw-parser-output .navbox .hlist td ol,.mw-parser-output .navbox .hlist td ul,.mw-parser-output .navbox td.hlist dl,.mw-parser-output .navbox td.hlist ol,.mw-parser-output .navbox td.hlist ul{padding:0.125em 0}.mw-parser-output .navbox .navbar{display:block;font-size:100%}.mw-parser-output .navbox-title .navbar{float:left;text-align:left;margin-right:0.5em}hide.mw-parser-output .navbar{display:inline;font-size:88%;font-weight:normal}.mw-parser-output .navbar-collapse{float:left;text-align:left}.mw-parser-output .navbar-boxtext{word-spacing:0}.mw-parser-output .navbar ul{display:inline-block;white-space:nowrap;line-height:inherit}.mw-parser-output .navbar-brackets::before{margin-right:-0.125em;content:"[ "}.mw-parser-output .navbar-brackets::after{margin-left:-0.125em;content:" ]"}.mw-parser-output .navbar li{word-spacing:-0.125em}.mw-parser-output .navbar a>span,.mw-parser-output .navbar a>abbr{text-decoration:inherit}.mw-parser-output .navbar-mini abbr{font-variant:small-caps;border-bottom:none;text-decoration:none;cursor:inherit}.mw-parser-output .navbar-ct-full{font-size:114%;margin:0 7em}.mw-parser-output .navbar-ct-mini{font-size:114%;margin:0 4em}vteHeads of houses of the University of OxfordColleges
All Souls: Sir John Vickers
Balliol: Dame Helen Ghosh
Brasenose: John Bowers
Christ Church: Martyn Percy
Corpus Christi: Helen Moore
Exeter: Sir Rick Trainor
Green Templeton: Sir Michael Dixon
Harris Manchester: Jane Shaw
Hertford: Tom Fletcher
Jesus: Sir Nigel Shadbolt
Keble: Sir Jonathan Phillips
Kellogg: Jonathan Michie
Lady Margaret Hall: Christine Gerrard (interim)
Linacre: Nick Brown
Lincoln: Henry Woudhuysen
Magdalen: Dinah Rose
Mansfield: Helen Mountfield
Merton: Irene Tracey
New College: Miles Young
Nuffield: Sir Andrew Dilnot
Oriel: The Lord Mendoza
Pembroke: Sir Ernest Ryder
Queen's: Claire Craig
Reuben: Lionel Tarassenko
St Anne's: Helen King
St Antony's: Roger Goodman
St Catherine's: Kersti Börjars
St Cross: Carole Souter
St Edmund Hall: Kathy Willis
St Hilda's: Georgina Paul (acting)
St Hugh's: Dame Elish Angiolini
St John's: Margaret Snowling
St Peter's: Judith Buchanan
Somerville: The Baroness Royall of Blaisdon
Trinity: Dame Hilary Boulding
University: The Baroness Amos
Wadham: Robert Hannigan
Wolfson: Tim Hitchens
Worcester: David Isaac
Permanent private halls
Blackfriars: John O'Connor
Campion Hall: Nicholas Austin
Regent's Park College: vacant
St Benet's Hall: Richard Cooper
St Stephen's House: Robin Ward
Wycliffe Hall: Michael Lloyd
Recognised independent centres
Buddhist Studies: Richard Gombrich
Energy Studies: Bassam Fattouh
Hebrew and Jewish Studies: Judith Olszowy-Schlanger
Hindu Studies: Shaunaka Rishi Das
Islamic Studies: Farhan Nizami
 University of Oxford portal


.mw-parser-output .asbox{position:relative;overflow:hidden}.mw-parser-output .asbox table{background:transparent}.mw-parser-output .asbox p{margin:0}.mw-parser-output .asbox p+p{margin-top:0.25em}.mw-parser-output .asbox-body{font-style:italic}.mw-parser-output .asbox-note{font-size:smaller}.mw-parser-output .asbox .navbar{position:absolute;top:-0.75em;right:1em;display:none}This biography of an academic is a stub. You can help Wikipedia by expanding it.vte




<img src="//en.wikipedia.org/wiki/Special:CentralAutoLogin/start?type=1x1" alt="" title="" width="1" height="1" style="border: none; position: absolute;" />
Retrieved from "https://en.wikipedia.org/w/index.php?title=Claire_Craig&oldid=1046962500"
		Categories: Living peopleAlumni of Newnham College, CambridgeProvosts of The Queen's College, OxfordScience communicatorsAcademic biography stubsHidden categories: Articles with short descriptionShort description is different from WikidataAC with 0 elementsYear of birth missing (living people)All stub articles
	